0,0,0,0,0,0,0,0,0,0,0,0,0,0,0,0,0,0,0,0,0,0,0,0,0,0,0,0,0,0,0,0,0,0
0,0,0,0,0,0,0,0,0,0,0,0,0,0,0,0,0,0,0,0,0,0,0,0,0,0,0,0,0,0,0,0,0,0
18,18,18,18,18,18,18,18,18,18,18,18,18,18,18,18,18,18,18,18,18,18,18,18,18,18,18,18,18,18,18,18,18,18
18,18,18,18,0,0,0,0,0,0,0,0,18,0,0,0,0,0,0,0,18,18,18,0,0,0,18,18,18,18,18,18,18,18
18,18,18,18,0,18,18,18,0,18,18,0,0,18,0,18,18,18,0,18,18,18,18,0,18,0,18,18,18,18,18,18,18,18
18,18,18,0,0,18,18,0,0,0,18,19,0,18,0,18,18,18,0,0,0,0,0,0,18,0,0,0,0,0,0,0,0,18
18,18,0,0,18,0,18,18,0,18,18,0,0,0,18,18,18,18,18,18,0,18,18,18,18,0,18,18,18,18,18,18,0,18
18,18,0,0,18,0,18,18,0,18,18,18,0,18,18,18,18,0,18,18,0,18,18,18,18,0,0,0,18,18,18,18,0,18
18,18,0,18,0,0,0,0,0,0,0,18,0,18,18,0,0,0,0,0,0,0,0,0,0,0,18,0,0,0,0,18,0,18
18,18,0,18,0,18,18,18,18,18,18,18,0,18,18,18,0,18,18,18,18,18,18,18,18,18,18,18,18,18,0,18,0,18
18,18,0,18,0,18,18,0,18,18,18,18,0,0,18,18,0,18,0,18,18,18,18,0,0,0,0,0,0,0,0,18,18,18
18,18,0,18,0,18,18,0,0,0,18,18,18,0,18,18,0,0,0,18,18,18,18,0,18,18,0,0,0,18,0,18,18,18
0,0,0,0,0,18,18,0,18,0,18,18,0,0,0,18,18,18,0,18,0,0,0,0,18,18,0,0,0,18,0,0,0,0
18,18,0,18,18,18,18,0,18,0,18,18,0,18,0,0,0,0,0,0,0,18,18,18,18,18,18,18,0,18,18,18,0,18
18,18,0,0,0,0,0,0,18,0,18,0,0,18,18,18,18,18,0,18,18,18,18,0,0,0,0,18,0,18,18,18,0,18
18,18,0,0,18,18,0,18,18,18,18,18,18,18,18,18,18,18,0,0,0,0,0,0,18,18,18,18,0,18,0,18,0,18
18,18,0,0,18,18,0,0,0,0,18,0,0,0,0,18,18,18,18,0,18,18,18,18,18,18,18,18,0,18,0,18,0,18
18,18,0,0,18,18,18,18,18,0,18,0,18,18,0,0,0,0,18,0,18,18,18,18,0,0,0,0,0,18,0,18,0,18
18,18,0,18,18,18,0,18,18,0,18,0,18,18,18,18,18,18,18,0,18,18,18,18,0,18,18,18,18,18,0,18,0,18
18,18,0,18,18,0,0,18,0,0,18,0,18,0,0,0,0,0,0,0,18,18,18,18,0,18,0,18,18,0,0,18,0,18
18,18,0,18,18,0,0,18,0,0,0,0,18,0,0,0,0,0,0,0,0,0,0,0,0,18,0,0,18,0,18,18,0,18
18,18,0,0,0,0,18,18,18,18,0,18,18,0,18,0,18,18,18,18,18,0,18,18,18,18,18,0,18,0,18,18,0,18
18,18,0,0,0,0,18,18,18,18,0,0,0,0,18,0,0,0,18,18,18,0,0,0,0,0,0,0,0,0,0,0,18,18
18,18,18,18,18,18,18,18,18,18,18,18,18,18,18,18,18,18,18,18,18,18,18,18,18,18,18,18,18,18,18,18,18,18
18,18,18,18,18,18,18,18,18,18,18,18,18,18,18,18,18,18,18,18,18,18,18,18,18,18,18,18,18,18,18,18,18,18
